M,M,M,M,M,M,M,M,M
M,C_b,C,C,M,C,C,C,M
M,C,M,C,C,C,M,C,M
M,C,C,M,M,C,M,C_m,M
M,C,M,C,C,C,M,C,M
M,C,C,M,C,C,C,C,M
M,M,M,M,M,M,M,M,M
