M,C,C,C,M,C,M,M,R,C
M,R,C,C,M,M,C,R,C,C
C,C,C,M,C,C,C,M,R,M
B,C,C,C,R,M,C,E,C,C
C,M,C,C,C,R,C,R,C,C
M,C,R,M,M,R,R,C,C,M
C,R,C,R,M,C,C,C,M,C
M,C,C,C,M,M,M,C,C,R
C,C,C,M,R,C,R,C,C,C
C,C,R,M,C,C,C,M,C_g
