M,M,M,M,M,M,M,M,M,M,M,M,M
M,C,C,C,M,C,C,C,C,C,M,E,M
M,M,M,C,M,C,M,M,M,C,C,C,M
M,C,C,E,C,C,C,C,C,C,M,C,M
M,C,M,M,M,E,M,C,M,C,C,C,M
M,C,M,C,M,M,M,C,M,M,C,M,M
M,C,C,C,C,C,C,C,M,C,C,C,M
M,M,M,C,M,C,M,M,M,C,M,M,M
M,C,M,C,M,C,C,C,C,C,C,C,M
M,C,C,C,M,C,M,C,M,M,M,M,M
M,C,M,C,M,C,M,C,C,C,M,C_g,M
M,B,C,C,C,C,M,C,M,C,R,C,M
M,M,M,M,M,M,M,M,M,M,M,M,M