M,M,M,M,M,M,M,M,M,M,M,M,M,M,M
M,C_g,C,C,C,E,C,C,C,C,C,C,C,C,M
M,C,M,M,M,M,M,C,M,C,M,C,M,C,M
M,C,C,C,C,C,C,C,M,C,M,C,C,C,M
M,M,C,M,M,M,M,C,C,C,C,C,M,C,M
M,C,C,C,C,C,C,C,M,C,M,C,M,C,M
M,C,M,M,M,C,M,M,M,C,C,C,M,C,M
M,E,C,C,C,C,C,B,C,C,M,C,C,C,M
M,M,M,M,M,M,M,M,M,M,M,M,M,M,M
