M,M,M,M,M,M,M,M,M,M,M,M,M,M,M
M,M,M,M,M,M,M,M,M,M,M,M,M,M,M
M,M,M,M,M,M,M,M,M,M,M,M,M,M,M
M,C,C,C,C,C,C,C,C,C,E,C,C,C_g,M
M,C,M,M,M,M,M,M,M,C,M,M,M,C,M
M,C,C,E,C,B,C,C,C,C,C,C,C,C,M
M,M,M,M,C,M,M,M,C,M,M,M,M,C,M
M,M,M,M,C,C,C,C,C,C,C,C,C,C,M
M,M,M,M,M,M,M,M,M,M,M,M,M,M,M